1111111111111111111111111111111
1000P00001000000000000000100001
1000000001000000000000E00000011
1000000000000000C00000000111111
1000000001000000000000000000001
100000000100000000000000000001
1000000C0000000C000000000000001
1111111111111111111111111111111
